['2', '3', '3', 'X', '6']
['4', 'X', '3', '2', '3']
['3', '0', '1', '6', 'X']
['I', '6', '5', '8', '5']
['S', '6', 'R', 'C', '1']
['C', '7', 'R', '6', '5']
